1,J,K,,,,,
6,25,0,4,,,,
,,,,,,,
0,0,0,0,0,0,0,0
0,0,0,0,0,0,0,0
0,0,13,12,0,0,0,0
0,0,0,11,0,17,18,0
0,9,8,10,15,16,0,0
0,0,7,5,6,0,0,0
0,0,0,4,0,0,0,0
0,0,2,1,3,0,0,0
14,,,,,,,